...wwwwwwwwwwwww
......W.....W..W
W..wwwwwww..W..D
W..W...........W
W..wd.....wdw..W
D..............W
W..W......www..W
W..W..W..W.....W
Wwww..W..wwwwwww
W...............
Wwwwwwwwwwwww...