Wwwwwwwwwwwwwwww
W.....W.....W..W
W..wwwwwww..W..D
W..W...........W
W..ww.....www..W
D..............W
W..W......www..W
W..W..W..W.....W
Wwww..W..wwwwwwW
W..............W
WwwwwwwwwwwwwwwW