WWWWWWWD
WFFFFFWD
WWWWWWWD
WFFWFFWD
WFFWFFWD
WWWWWWWD